12
#######.####
#####...####
#.....#.####
#.##########
#.##.......#
#.#.#.####.#
#.#.###....#
#.#.....#.##
#...#####..#
##########.#
###........#
###.########
