12
#######.####
#####...####
#####.#.####
#####.#.####
####....####
############
############
############
############
############
############
############
